#########
#  . .  #
# $#@#$ #
#       #
#########
