#########
#  . .  #
#   # $ #
# @ #$  #
#       #
#########
