##########
#  . . . #
# $ #$#$@#
#        #
##########
