###########
# .. ..   #
# $$ $$   #
#    @    #
###########
