#############
# .. .. ..  #
# $$$$#$$$@ #
#           #
#############
