########
# . .  #
# $#$  #
#  @   #
########
