 ###########
##         #
# $ $      #
#. @      .#
############