#############
# .. .. ..  #
# $$ $#$$$@ #
#           #
#############
