##########
#        #
#  @     #
#  ##    #
#    $   #
#  ####  #
#    .   #
#        #
#        #
#  #######
##########