##########
#        #
#        #
#  ##    #
#    $   #
#  ####  #
#    .   #
#        #
#    @   #
#  #######
##########